1111111111
1S00000001
1110111011
1000101011
1011101111
1000010101
1111011101
10000000E1
1111111111
