1111111111
1S00000001
1011101111
1000000001
1011101111
10000000E1
1111111111
